"a" = (/turf/space,/area/space)
"b" = (/turf/simulated/wall,/area/exterior/ocean)
"c" = (/turf/simulated/floor/tiled,/area/exterior/ocean)
"d" = (/obj/machinery/light{dir = 1},/turf/simulated/floor/tiled,/area/exterior/ocean)
"e" = (/obj/effect/landmark{name = "tdome1"},/turf/simulated/floor/tiled,/area/exterior/ocean)
"f" = (/obj/effect/floor_decal/industrial/hatch/yellow,/turf/simulated/floor/tiled,/area/exterior/ocean)
"g" = (/obj/machinery/light_switch{pixel_x = 25},/turf/simulated/floor/tiled,/area/exterior/ocean)
"h" = (/obj/machinery/light{icon_state = "tube1"; dir = 8},/turf/simulated/floor/tiled,/area/exterior/ocean)
"i" = (/obj/structure/ladder/up,/turf/simulated/floor/tiled,/area/exterior/ocean)
"j" = (/obj/machinery/light{icon_state = "tube1"; dir = 4},/turf/simulated/floor/tiled,/area/exterior/ocean)
"k" = (/obj/machinery/atmospherics/unary/vent_pump/on,/turf/simulated/floor/tiled,/area/exterior/ocean)
"l" = (/obj/machinery/atmospherics/pipe/simple/visible{icon_state = "intact"; dir = 5},/turf/simulated/floor/tiled,/area/exterior/ocean)
"m" = (/obj/machinery/atmospherics/pipe/simple/visible{icon_state = "intact"; dir = 4},/turf/simulated/floor/tiled,/area/exterior/ocean)
"n" = (/obj/machinery/atmospherics/portables_connector{icon_state = "map_connector"; dir = 8},/obj/machinery/portable_atmospherics/canister/air,/turf/simulated/floor/tiled,/area/exterior/ocean)
"o" = (/obj/machinery/light_switch{pixel_x = -25},/turf/simulated/floor/tiled,/area/exterior/ocean)
"p" = (/obj/effect/landmark/start,/turf/simulated/floor/tiled,/area/exterior/ocean)
"q" = (/obj/effect/landmark/test/safe_turf,/turf/simulated/floor/tiled,/area/exterior/ocean)
"r" = (/obj/machinery/atmospherics/pipe/simple/visible{icon_state = "intact"; dir = 6},/turf/simulated/floor/tiled,/area/exterior/ocean)
"s" = (/obj/machinery/atmospherics/portables_connector{icon_state = "map_connector"; dir = 8},/obj/machinery/portable_atmospherics/canister/empty,/turf/simulated/floor/tiled,/area/exterior/ocean)
"t" = (/obj/machinery/door/airlock/external/bolted{frequency = 1379; id_tag = "lower_level_dock_hatch"},/turf/simulated/floor,/area/exterior/ocean)
"u" = (/obj/machinery/embedded_controller/radio/simple_docking_controller{id_tag = "lower_level_dock"; pixel_x = -8; pixel_y = -25},/turf/simulated/floor,/area/exterior/ocean)
"v" = (/turf/simulated/floor,/area/exterior/ocean)
"w" = (/obj/machinery/atmospherics/unary/vent_scrubber/on{icon_state = "map_scrubber_on"; dir = 1},/turf/simulated/floor/tiled,/area/exterior/ocean)
"x" = (/obj/effect/landmark{name = "JoinLate"},/turf/simulated/floor/tiled,/area/exterior/ocean)
"y" = (/turf/simulated/wall/iron,/area/shuttle/escape)
"z" = (/obj/effect/wingrille_spawn/reinforced,/turf/simulated/floor/plating,/area/shuttle/escape)
"A" = (/obj/machinery/computer/shuttle_control{shuttle_tag = "Example"},/turf/simulated/floor/plating,/area/shuttle/escape)
"B" = (/obj/structure/bed/chair{dir = 1},/obj/machinery/embedded_controller/radio/simple_docking_controller{id_tag = "example_shuttle_starboard"; pixel_x = 28},/obj/machinery/embedded_controller/radio/simple_docking_controller{id_tag = "example_shuttle_port"; pixel_x = -28},/turf/simulated/floor/plating,/area/shuttle/escape)
"C" = (/obj/machinery/light,/turf/simulated/floor/plating,/area/shuttle/escape)
"D" = (/obj/machinery/door/airlock/external/bolted{frequency = 1379; id_tag = "example_shuttle_port_hatch"},/turf/simulated/floor/plating,/area/shuttle/escape)
"E" = (/obj/machinery/door/airlock/external/bolted{frequency = 1379; id_tag = "example_shuttle_starboard_hatch"},/turf/simulated/floor/plating,/area/shuttle/escape)
"F" = (/obj/structure/cable{d2 = 2; icon_state = "0-2"; pixel_y = 0},/obj/machinery/power/apc{dir = 8; name = "west bump"; pixel_x = -24},/turf/simulated/floor/tiled,/area/exterior/ocean)
"G" = (/obj/structure/cable{d1 = 1; d2 = 2; icon_state = "1-2"; pixel_y = 0},/turf/simulated/floor/tiled,/area/exterior/ocean)
"H" = (/obj/structure/cable,/obj/machinery/power/debug_items/infinite_generator,/turf/simulated/floor/tiled,/area/exterior/ocean)
"I" = (/obj/machinery/light,/turf/simulated/floor/tiled,/area/exterior/ocean)
"J" = (/obj/effect/landmark/test/exterior_turf,/turf/space,/area/space)

(1,1,1) = {"
aaaaaaaaaaaaaaaaaaaaaaaaaaaaaaaaaaaaaaaaaaaaaaaa
aaaaaaaaaaaaaaaaaaaaaaaaaaaaaaaaaaaaaaaaaaaaaaaa
aaaaaaaaaaaaaaaaaaaaaaaaaaaaaaaaaaaaaaaaaaaaaaaa
aaaaaaaaaaaaaaaaaaaaaaaaaaaaaaaaaaaaaaaaaaaaaaaa
aaaaaaaaaaaaaaaaaaaaaaaaaaaaaaaaaaaaaaaaaaaaaaaa
aaaaaaaaaaaaaaaaaaaaaaaaaaaaaaaaaaaaaaaaaaaaaaaa
aaaaaaaaaaaaaaaaaaaaaaaaaaaaaaaaaaaaaaaaaaaaaaaa
aaaaaaaaaaaaaaaaaaaaaaaaaaaaaaaaaaaaaaaaaaaaaaaa
aaaaaaaaaaaaaaaaaaaaaaaaaaaaaaaaaaaaaaaaaaaaaaaa
aaaaaaaaaaaaaaaaabbbbbbbbbbbbbbbaaaaaaaaaaaaaaaa
aaaaaaaaaaaaaaaaabcccdcccccdcccbaaaaaaaaaaaaaaaa
aaaaaaaaaaaaaaaaabceeecfbfcccccbaaaaaaaaaaaaaaaa
aaaaaaaaaaaaaaaaabceeecfffccccgbaaaaaaaaaaaaaaaa
aaaaaaaaaaaaaaaaabheeeifffccccjbaaaaaaaaaaaaaaaa
aaaaaaaaaaaaaaaaabcccccccccckccbaaaaaaaaaaaaaaaa
aaaaaaaaaaaayyyaabcccccccccclmnbaaaaaaaaaaaaaaaa
aaaaaaaaaaaazAzaabocccccpccccccbaaaaaaaaaaaaaaaa
aaaaaaaaaaaazBzbbbccccqcccccrmsbaaaaaaaaaaaaaaaa
aaaaaaaaaaaaDCEtuvccccccccccwccbaaaaaaaaaaaaaaaa
aaaaaaaaaaaayyybbbhcxxxcccccccjbaaaaaaaaaaaaaaaa
aaaaaaaaaaaaaaaaabFcxxxccccccccbaaaaaaaaaaaaaaaa
aaaaaaaaaaaaaaaaabGcxxxccccccccbaaaaaaaaaaaaaaaa
aaaaaaaaaaaaaaaaabHccIcccccIcccbaaaaaaaaaaaaaaaa
aaaaaaaaaaaaaaaaabbbbbbbbbbbbbbbaaaaaaaaaaaaaaaa
aaaaaaaaaaaaaaaaaaaaaaaaaaaaaaaaaaaaaaaaaaaaaaaa
aaaaaaaaaaaaaaaaaaaaaaaaaaaaaaaaaaaaaaaaaaaaaaaa
aaaaaaaaaaaaaaaaaaaaaaJaaaaaaaaaaaaaaaaaaaaaaaaa
aaaaaaaaaaaaaaaaaaaaaaaaaaaaaaaaaaaaaaaaaaaaaaaa
aaaaaaaaaaaaaaaaaaaaaaaaaaaaaaaaaaaaaaaaaaaaaaaa
aaaaaaaaaaaaaaaaaaaaaaaaaaaaaaaaaaaaaaaaaaaaaaaa
aaaaaaaaaaaaaaaaaaaaaaaaaaaaaaaaaaaaaaaaaaaaaaaa
aaaaaaaaaaaaaaaaaaaaaaaaaaaaaaaaaaaaaaaaaaaaaaaa
"}
