"a" = (/turf/simulated/wall,/area/exterior/ocean)
"b" = (/obj/effect/landmark/map_data{height = 2},/turf/space,/area/space)
"c" = (/obj/effect/floor_decal/corner/blue/diagonal,/turf/simulated/floor/tiled,/area/exterior/ocean)
"d" = (/obj/machinery/light{dir = 1},/obj/effect/floor_decal/corner/blue/diagonal,/turf/simulated/floor/tiled,/area/exterior/ocean)
"e" = (/obj/structure/lattice,/turf/simulated/open,/area/exterior/ocean)
"f" = (/turf/simulated/open,/area/exterior/ocean)
"g" = (/obj/machinery/light_switch{pixel_x = 25},/obj/effect/floor_decal/corner/blue/diagonal,/turf/simulated/floor/tiled,/area/exterior/ocean)
"h" = (/obj/machinery/light{icon_state = "tube1"; dir = 8},/obj/effect/floor_decal/corner/blue/diagonal,/turf/simulated/floor/tiled,/area/exterior/ocean)
"i" = (/turf/space,/area/space)
"j" = (/obj/effect/floor_decal/corner/blue/diagonal,/obj/structure/ladder,/turf/simulated/floor/tiled,/area/exterior/ocean)
"k" = (/turf/simulated/floor,/area/exterior/ocean)
"l" = (/obj/machinery/embedded_controller/radio/simple_docking_controller{id_tag = "upper_level_dock"; pixel_x = 8; pixel_y = -25},/turf/simulated/floor,/area/exterior/ocean)
"m" = (/obj/machinery/door/airlock/external/bolted{frequency = 1379},/turf/simulated/floor,/area/exterior/ocean)
"n" = (/obj/machinery/atmospherics/unary/vent_pump/on,/obj/effect/floor_decal/corner/blue/diagonal,/turf/simulated/floor/tiled,/area/exterior/ocean)
"o" = (/obj/effect/floor_decal/corner/blue/diagonal,/obj/machinery/light{icon_state = "tube1"; dir = 4},/turf/simulated/floor/tiled,/area/exterior/ocean)
"p" = (/obj/machinery/atmospherics/pipe/simple/visible{icon_state = "intact"; dir = 5},/obj/effect/floor_decal/corner/blue/diagonal,/turf/simulated/floor/tiled,/area/exterior/ocean)
"q" = (/obj/machinery/atmospherics/pipe/simple/visible{icon_state = "intact"; dir = 4},/obj/effect/floor_decal/corner/blue/diagonal,/turf/simulated/floor/tiled,/area/exterior/ocean)
"r" = (/obj/machinery/atmospherics/portables_connector{icon_state = "map_connector"; dir = 8},/obj/machinery/portable_atmospherics/canister/air,/obj/effect/floor_decal/corner/blue/diagonal,/turf/simulated/floor/tiled,/area/exterior/ocean)
"s" = (/obj/machinery/atmospherics/pipe/simple/visible{icon_state = "intact"; dir = 6},/obj/effect/floor_decal/corner/blue/diagonal,/turf/simulated/floor/tiled,/area/exterior/ocean)
"t" = (/obj/machinery/atmospherics/portables_connector{icon_state = "map_connector"; dir = 8},/obj/machinery/portable_atmospherics/canister/empty,/obj/effect/floor_decal/corner/blue/diagonal,/turf/simulated/floor/tiled,/area/exterior/ocean)
"u" = (/obj/machinery/light_switch{pixel_x = -25},/obj/effect/floor_decal/corner/blue/diagonal,/turf/simulated/floor/tiled,/area/exterior/ocean)
"v" = (/obj/machinery/atmospherics/unary/vent_scrubber/on{icon_state = "map_scrubber_on"; dir = 1},/obj/effect/floor_decal/corner/blue/diagonal,/turf/simulated/floor/tiled,/area/exterior/ocean)
"w" = (/obj/machinery/light{icon_state = "tube1"; dir = 4},/obj/effect/floor_decal/corner/blue/diagonal,/turf/simulated/floor/tiled,/area/exterior/ocean)
"x" = (/obj/structure/cable{d2 = 2; icon_state = "0-2"; pixel_y = 0},/obj/machinery/power/apc{dir = 8; name = "west bump"; pixel_x = -24},/obj/effect/floor_decal/corner/blue/diagonal,/turf/simulated/floor/tiled,/area/exterior/ocean)
"y" = (/obj/structure/cable{d1 = 1; d2 = 2; icon_state = "1-2"; pixel_y = 0},/obj/effect/floor_decal/corner/blue/diagonal,/turf/simulated/floor/tiled,/area/exterior/ocean)
"z" = (/obj/structure/cable,/obj/machinery/power/debug_items/infinite_generator,/obj/effect/floor_decal/corner/blue/diagonal,/turf/simulated/floor/tiled,/area/exterior/ocean)
"A" = (/obj/machinery/light,/obj/effect/floor_decal/corner/blue/diagonal,/turf/simulated/floor/tiled,/area/exterior/ocean)

(1,1,1) = {"
iiiiiiiiiiiiiiiiiiiiiiiiiiiiiiiiiiiiiiiiiiiiiiii
iiiiiiiiiiiiiiiiiiiiiiiiiiiiiiiiiiiiiiiiiiiiiiii
iiiiiiiiiiiiiiiiiiiiiiiiiiiiiiiiiiiiiiiiiiiiiiii
iiiiiiiiiiiiiiiiiiiiiiiiiiiiiiiiiiiiiiiiiiiiiiii
iiiiiiiiiiiiiiiiiiiiiiiiiiiiiiiiiiiiiiiiiiiiiiii
iiiiiiiiiiiiiiiiiiiiiiiiiiiiiiiiiiiiiiiiiiiiiiii
iiiiiiiiiiiiiiiiiiiiiiiiiiiiiiiiiiiiiiiiiiiiiiii
iiiiiiiiiiiiiiiiiiiiiiiiiiiiiiiiiiiiiiiiiiiiiiii
iiiiiiiiiiiiiiiiiiiiiiiiiiiiiiiiiiiiiiiiiiiiiiii
iiiiiiiiiiiiibiiiaaaaaaaaaaaaaaaiiiiiiiiiiiiiiii
iiiiiiiiiiiiiiiiiacccdcceccdcccaiiiiiiiiiiiiiiii
iiiiiiiiiiiiiiiiiaccccceeecccccaiiiiiiiiiiiiiiii
iiiiiiiiiiiiiiiiiacccccfffccccgaaaaiiiiiiiiiiiii
iiiiiiiiiiiiiiiiiahcccjfffccccckklmiiiiiiiiiiiii
iiiiiiiiiiiiiiiiiaccccccccccncoaaaaiiiiiiiiiiiii
iiiiiiiiiiiiiiiiiaccccccccccpqraiiiiiiiiiiiiiiii
iiiiiiiiiiiiiiiiiacccccccccccccaiiiiiiiiiiiiiiii
iiiiiiiiiiiiiiiiiaccccccccccsqtaiiiiiiiiiiiiiiii
iiiiiiiiiiiiiiiiiaucccccccccvccaiiiiiiiiiiiiiiii
iiiiiiiiiiiiiiiiiahcccccccccccwaiiiiiiiiiiiiiiii
iiiiiiiiiiiiiiiiiaxccccccccccccaiiiiiiiiiiiiiiii
iiiiiiiiiiiiiiiiiayccccccccccccaiiiiiiiiiiiiiiii
iiiiiiiiiiiiiiiiiazccAcccccAcccaiiiiiiiiiiiiiiii
iiiiiiiiiiiiiiiiiaaaaaaaaaaaaaaaiiiiiiiiiiiiiiii
iiiiiiiiiiiiiiiiiiiiiiiiiiiiiiiiiiiiiiiiiiiiiiii
iiiiiiiiiiiiiiiiiiiiiiiiiiiiiiiiiiiiiiiiiiiiiiii
iiiiiiiiiiiiiiiiiiiiiiiiiiiiiiiiiiiiiiiiiiiiiiii
iiiiiiiiiiiiiiiiiiiiiiiiiiiiiiiiiiiiiiiiiiiiiiii
iiiiiiiiiiiiiiiiiiiiiiiiiiiiiiiiiiiiiiiiiiiiiiii
iiiiiiiiiiiiiiiiiiiiiiiiiiiiiiiiiiiiiiiiiiiiiiii
iiiiiiiiiiiiiiiiiiiiiiiiiiiiiiiiiiiiiiiiiiiiiiii
iiiiiiiiiiiiiiiiiiiiiiiiiiiiiiiiiiiiiiiiiiiiiiii
"}
